y w g b r e b r w y r b r g b
r r g g b e b y r r b b y w w
g w b b r r r r y b g b e y w
g r g w y r e b y b b b r r w
r y b g w b r g w y r e b b r
r w y r e w y b b b g r g r b
b r b w r e g r r b y w b g y
w y w r y b e b r r b b g r g
b w b w r g b g y b y e r r r
b b r w y r w y b e r g g r b
y r e b g b y g r b w r b r w
g w y r b b e r r r y w g b b
r r b g y w b g w b b y r e r
b e g w y r r b b r g y w b r
y b b r w w e b r g r g y b r
w b g e y g w b b r y r b r r
r r g w g b e r w b b y y r b
b e b b y y r g r g w r b r w
w b y g r y e r r g b r b w b
r y e w b b b r r g y g b w r
g g r b b y w r r y b e b w r
r r r b y w y b r g e b w b g
b y g r r b b e r g r y b w w
y b r w g b r r w b g b e r y
r w b r g y g b r b r y b e w
r r b b g e b y w y b w r r g
r r b e y r b b b y g w r w g
e g y r g r r b y b w w b r b
e r r b w w g r b r y b b y g
b y r g w b r r b r w y g b e
