g y r b p r e y r g p w b r w
g e p g y p w y r w b b r r r
p e g r p r w g r y y b r b w
r p r y w e r y b g g b w r p
r g r p b p g b r y w y r w e
p r b b r w r g e y y r p w g
g p g b r y b r r y e r p w w
r p y g e r r r y w w g b b p
y g y e g p r r p b b w w r r
p w p y r y b e r r b r g g w
