r r r r e b r w w b b r y y b
r w b y w r r y b e r r r b b
r b y r w b b r b w r r e r y
r b y b r b w r r e y r b w r
r b r b w r y b r y e r r b w
w w b r r y b r b r e b y r r
r b y r w b r r r b y e r b w
b y r b e w r r r y b r b r w
b w e y r r y r r r b r b b w
r b r y r r r w b e r y w b b
b r e r b r r b y w y b w r r
w b b w y y r e r r b r r b r
b y r b b r w e r b w r y r r
y r w b r r r w b e r r y b b
b b r y y r r w r e r b b w r
r r b b r w e r b r y w y b r
r r e r r r y r w b b b w y b
y b r r e w b r b b r y r w r
r y r r y w b b b b r e w r r
w r b y r b r y b r b r w r e
r e b r y b y w b b r r w r r
r b y b r e w r b r b r w r y
y w y r r r b b r e w b b r r
y r b b r r e r b w y r r b w
r b y b w r r w r b r b e r y
b r r r r e b b r w b w r y y
b b r w r r y r r r b w e y b
y w r y e b b r r r r b b w r
r b r y b r b r r e r w y w b
r r y b r b w e r r b r w y b
b r w b r r r b b w r y y r e
w r r b w r y r e r y r b b b
r y r r r b e b w r b y w b r
b y e y w r w r b b r r r b r
r b y w w r r y b b r r e b r
b r r b y r r r b w r w e b y
r r r r r w w b y y b r e b b
r b b r r w e b y w r b r r y
r b w r y r r r b b e w b y r
e r b y r b r w r w r r y b b
r y r w e r b b r y b r w r b
r w r b b r b r w r y y b e r
b r b w r r b b r w y r y r e
r y r w r b b r w b r b e r y
r r r y e r w r w b b b y b r
w r b r r r y r y e w r b b b
e b w r b r r r b y r w y r b
y e y r b b r r r w w r b b r
y r y b b w r r e w r r r b b
e w r r r y y b b r b r b w r
