b r b b r w r w r b b r e r b
w b r b r e b b r b r b r w r
r b b e r b r b b b r r w r w
w b b r b r b r r b r w r b e
r b b b r b r b w r b e w r r
r b e r b w r r w r b b b b r
r w r r r b b b b b r r w b e
r b b b r b b e b r r r r w w
r r w b e b w r r b b r r b b
r r b r r b b w b b r e r b w
w r b b r b r r b w b r e b r
b r b b b r b r w e r r w r b
b b b w b r e r b r r w r r b
r b b w r b b r e w b r b r r
r r r r w e r b r w b b b b b
b r b r w b b b e r r r r w b
e b b r b w r b r b r b r w r
r r b w r r b b r r b e b b w
w r b b r e r w r b r b r b b
b r r b r w r w b r b b b r e
r r r b r b e w b w r r b b b
b b b r w r r r w b r b b e r
w b r r r b e b r b r b b w r
e b r b r r r b r b b r w w b
b b r b r b b e r r r w b w r
b w e r b r b b r w r b b r r
b r r b b r b b b r r r e w w
b b w r b r b r r r b w r e b
e b r b r r r r b w b b w r b
r r r b b r b b r r e b w w b
b b r r b w r r b e r b r w b
r b b r r e w b w r r b b b r
w b r e b r r r b b b r b r w
w r b r b r e b b r w b r r b
r r w r b b b b b e r b r w r
r b r r b b b e w b r r w r b
r e r b b r b r b r r b w w b
r r b b b e b r w r r w b b r
r r w e b b r w r r b b b b r
b b r r r e r b b b w b r w r
r b w r b b w b b r e r r b r
r w b r b r b r w r b r e b b
b b r b w b r w r b r r e r b
r b r b b r b r b w r e w r b
r e b b r b w r r r b b b r w
r w b r b b b b e r r w b r r
b w b r b b r b b r r r e w r
r r b r r r b e w b b b r w b
r r b w w b b b e r r r b b r
r w w r r b r b b b r b b r e
