w r w b g y g r b e y r b r b
y w b w g b r r r b y r b g e
b w y e b g r r b r y w b g r
r b g b w e b r r y y g w b r
r r w y g w r g e y b r b b b
y w b e b r y g r r b w b g r
b g r r w b r w e y g b b r y
y b g e y r g w b r b w r r b
w b g w r e b r r y g b y r b
r y g b b y r r b r b e w g w
g b r g y b b r r y w r b e w
r r w r b b g e w g y y b b r
b w y r b r r r e w b g g b y
w e r r g r b b b w r y y g b
b b g e b r y w r b r r w g y
b w y g b y b r r r b r e w g
g b y r g r r e b b b y w r w
g g w r b e r b b y w r r y b
b w b w y y b e g b r r g r r
b r b g b y e w r w r r b g y
r e b b g b r r g y b y w r w
r b r y w b w r r g y e b b g
r e r r b y w b g r b g w b y
y r b b b y r w r r g w e g b
r y e w w r g g r b b r b b y
g b e r g y b w b b r y w r r
b r w b r r g y e g b b y r w
g b y r g w w e b r r b r y b
b g b b g r r r w r w y y b e
g b r r y b r b b y g w e r w
