r e g w p b r g w b y p y r r
w p g b r r r r p y y b g e w
y g y r p w p b r r e b g w r
b e g r r r p y w r w g y p b
p w g p b g r w b e r y r r y
b w p e w r g y p g y r r r b
b b g p p r w y g r y r r w e
w r b b e p y g w r g r r p y
p w p r r g w y g e r b r y b
g w g w r y e b y b r p p r r
