r b r b b r r y y e w r r w b
b r y b r y b w w b r r r e r
r b r b e r y y b r b r r w w
y b b r w w e b r y r r r r b
r r w w r e b r b b y y r r b
b b y w r w r r y b r r b r e
y r r w y r r r r b e b b b w
r r e b r b y w y b r b r w r
r e w b b r r y b y r r r w b
y b b w r r r y e r b w r r b
e b r r w y y r r w r b r b b
r y r e y r b r r w b b r w b
b y w r e b b y w r r r r b r
y r r e y r r b b r b b w r w
b b r e y r r r y b r w w r b
b b r w w b r b r e r y r r y
b w r b r r r b b y r e r y w
y b b r w b w r e r r y r r b
r r r r b b r w w r b b y y e
b b e r b b r y w r y r r r w
w r r b b r y r b r y w e r b
b r b y b b y r r r w r w e r
w r b y b y b r r e w r r r b
r w r b r r r y b r b w e y b
b r y w y w b r b r r r b e r
w r e r b b r r y r w b y r b
r r y b b r r y w e r r b w b
r b y r r y b w r r w r e b b
b r y y b b r b e r w r r w r
b r r r y b e b y w r r r w b
r e w w r b y r b b r y r r b
b r w r r y b y w r b r e r b
b r y b e b r w r w y r r r b
e w r b b r y y r r w r r b b
b r b r w r r y b r y e w b r
b y r w r r b r r w e r b b y
r r b w y b b r b w r e r y r
r r w b b b r e y r b w r y r
e r b r r y r y w b r w b b r
b r w b r r r b r r e y y w b
w r r r b r r e w y b y b b r
r b r b r w e b r r b y y r w
b b y w r w e r r b r r y b r
e r y w r b b b y w b r r r r
b r r w b e y r b y r b r r w
y r r r e w r r b y b w r b b
r b y w r b b y b r w r e r r
r b w r r y r b y b b r w r e
b r w y r w b r y b e b r r r
w r r r w b y e r b y b r b r
